11111111111111
10010000000C01
1000011111N0C1
1P0011E0000001
11111111111111