11111111111111
10010000000C01
100001111100C1
1P0011E0000001
11111111111111